My Humps -- The Black Eyed Peas
September -- Earth, Wind & Fire
Majora's Mask - Overworld/Termina Field (Instrumental Remix) (The Legend of Zelda) -- Monsalve
We Want Some P--sy -- 2 LIVE CREW
Gays 4 Donald -- Pink Guy
Theme From New York, New York -- Frank Sinatra
Shake That Ass Bitch - Original -- Splack Pack, Kidd Money
Chariots Of Fire -- Vangelis
Gucci Gang -- Lil Pump
S.I.M.P. (Squirrels in My Pants) -- 2 Guys n the Parque
Yeah! -- Usher, Lil Jon, Ludacris
Sanic Main Theme -- Sanic, Dr. Robotnek
Rocket Man (I Think It's Going To Be A Long, Long Time) -- Elton John
Gin And Juice (feat. Dat Nigga Daz) -- Snoop Dogg, Daz Dillinger
Dick In A Box -- The Lonely Island, Justin Timberlake
Scatman (ski-ba-bop-ba-dop-bop) -- Scatman John
Hotel California - Remastered -- Eagles
School -- Bill Wurtz
Sandstorm - Radio Edit -- Darude
Caught Up In You -- 38 Special
Back To The Future - From "Back To The Future" Original Score/End Credits -- The Outatime Orchestra
Young, Wild & Free (feat. Bruno Mars) -- Snoop Dogg, Wiz Khalifa, Bruno Mars
#SELFIE -- The Chainsmokers
He's a Bully -- Robbie Wyckoff
Teletubbies Say "Eh-Oh!" -- Teletubbies
Spear of Justice -- Toby Fox
Don't You (Forget About Me) - Remastered -- Simple Minds
Axel F -- Crazy Frog
Rap God -- Eminem
Boyz In The Hood -- Dynamite Hack
Hips Don't Lie -- Shakira, Wyclef Jean
All Day -- Wiz Khalifa, John Cena
Mickey Mouse Clubhouse Theme -- They Might Be Giants
Waterloo -- ABBA
Duval -- Flawda Water
Get on Your Feet -- Gloria Estefan
I Am Your Gummy Bear (The Gummy Bear Song) -- Gummibär
Ultimate -- Denzel Curry
All I Want for Christmas Is You -- Mariah Carey
We Are Number One -- SharaX
Oh Yeah - Remastered 2005 -- Yello
Carry on Wayward Son -- Kansas
Survivor -- Destiny's Child
Sunglasses At Night -- Corey Hart
Danger Zone -- Kenny Loggins
Ima Boss - feat. Rick Ross -- Meek Mill, Rick Ross
Queen of Mars -- Candace
Everything is Not What it Seems - Theme Song to Wizards of Waverly Place -- Selena Gomez
Hit or Miss -- Jacob Sartorius
Come Together -- Aerosmith
Shots -- LMFAO, Lil Jon
Uptown Funk -- Mark Ronson, Bruno Mars
PPAP (Pen Pineapple Apple Pen) - Long Version -- PIKOTARO
Threw It On The Ground -- The Lonely Island
Anaconda -- Nicki Minaj
Elmo's Rap Alphabet (Elmo Sings Rap Alphabet) -- Elmo
Litmas -- Jake Paul, Slim Jxmmi
Stfu -- Pink Guy
No Homo -- The Lonely Island
Kung Fu Fighting -- Carl Douglas
Uptown Girl -- Billy Joel
Gonna Fly Now - Theme From "Rocky" / Remastered -- Bill Conti
Dani California -- Red Hot Chili Peppers
rockstar -- Post Malone, 21 Savage
Ain't Got Rhythm -- Phineas, Sherman
Girlfriend -- Avril Lavigne
Opening Suite -- Martin O'Donnell, Michael Salvatori
The X-Files -- The City of Prague Philharmonic Orchestra
Bring Me To Life -- Evanescence
The Chipmunk Song (Christmas Don't Be Late) - Remastered 1999 -- Alvin & The Chipmunks, David Seville
Cold Hard Bitch -- Jet
Bad Moon Rising -- Creedence Clearwater Revival
The Best Day Ever -- Spongebob, Sandy, Mr. Krabs, Plankton & Patrick
Always Look On The Bright Side Of Life -- Monty Python
Rebel Yell - 1999 - Remaster -- Billy Idol
Holding Out for a Hero -- Bonnie Tyler
Ready for the Bettys -- The Bettys
Not Afraid -- Eminem
Perry the Platypus Theme -- Randy Crenshaw
So Yesterday -- Hilary Duff
Bonito -- Jarabe De Palo
Some Bodies Gonna Get It (Mark Henry) -- WWE, Three 6 Mafia
Ni**a Ni**a Ni**a -- Gangsta Rap
Kitty -- Rich Brian
Where's Gary? -- Spongebob, Sandy, Mr. Krabs, Plankton & Patrick
Mambo No. 5 (A Little Bit of...) -- Lou Bega
I Want To Know What Love Is - Remastered -- Foreigner
Ridin' -- Chamillionaire, Krayzie Bone
Christmas In Heaven -- Monty Python
1 Thot 2 Thot Red Thot Blue Thot -- Yung Gravy
Bohemian Rhapsody -- William Shatner, John Wetton
Feel Good Inc -- Gorillaz
Misirlou -- Dick Dale and his Del-Tones
P.Y.T. (Pretty Young Thing) -- Michael Jackson
The Boys Are Back in Town -- Thin Lizzy
Somebody's Watching Me - Single Version -- Rockwell
Hollaback Girl -- Gwen Stefani
Three More Weeks -- Elevator To Hell
I'm Alright - Theme from "Caddyshack" -- Kenny Loggins
I Don't Fuck With You -- Big Sean, E-40
Surf Rider -- The Lively Ones
Blue (Da Ba Dee) - Gabry Ponte Ice Pop Radio -- Eiffel 65, Gabry Ponte
More Than A Feeling -- Boston
Nyan Cat Theme -- Nyan Cat
Disco Miniature Golfing Queen -- Laura Dickinson
Vienna -- Billy Joel
Have You Ever Seen The Rain? -- Creedence Clearwater Revival
Scatman's World -- Scatman John
I2I -- Tevin Campbell, Rosie Gaines
Beat It - Single Version -- Michael Jackson
Smells Like Teen Spirit -- Nirvana
Thrift Shop -- Kidz Bop Kids
Music from the "Avengers: Infinity War" Trailer -- L'Orchestra Cinematique
Jizz In My Pants -- The Lonely Island
Zelda - Overworld (Instrumental Remix) (The Legend of Zelda) -- Monsalve
Take Me Home, Country Roads - Rerecorded -- John Denver
Cold As Ice -- Foreigner
Cherry Pie -- Warrant
Sweater Song -- Spongebob Squarepants
F.U.N. Song -- Spongebob Squarepants, Plankton
Burnin' Up -- Jonas Brothers
All Star -- Kidz Bop Kids
Wouldn't It Be Nice - Stereo Mix -- The Beach Boys
I'm A Believer - Radio Edit -- Smash Mouth
Foreplay / Long Time -- Boston
Sad Romance (A.K.A. Sad Violin) -- Ji Pyeong Kwon
Dearly Beloved (from "The Kingdom Hearts") -- Berlin Virtual Symphonics, Eddy Höfler
It Wasn't Me -- Shaggy, Ricardo Ducent
Goofy Goober Rock -- Spongebob Squarepants
Strange Fruit -- Billie Holiday
The Safety Dance -- Men Without Hats
Cult of Personality -- Living Colour
Dora The Explorer Party Mix (including "Dora The Explorer Theme" & "Travel Song") -- Dora The Explorer
NFL On FOX Theme -- Slumber Girlz U Rock
Who Let The Dogs Out -- Baha Men
Gummy Style -- Gummibär
In The Air Tonight - 2015 Remastered -- Phil Collins
You Make My Dreams -- Daryl Hall & John Oates
Still -- Geto Boys
Juke Box Hero -- Foreigner
Show Me Your Genitals -- Jon Lajoie
My Nemesis -- Danny Jacob
Hot For Teacher - 2015 Remastered Version -- Van Halen
Maniac -- Michael Sembello
Shooting Stars -- Bag Raiders
Complicated -- Avril Lavigne
Barbie Girl -- Aqua
I Came to Dig (Remastered) [feat. Captainsparklez] -- Tryhardninja, Captainsparklez
Bohemian Rhapsody - Remastered 2011 -- Queen
Livin' In The Sunlight, Lovin' In The Moon Light -- Tiny Tim
I Found A Way -- Drake Bell
Reading Rainbow Theme Song -- Reading Rainbow
(Rock) Superstar -- Cypress Hill
SpongeBob SquarePants Theme Song -- Spongebob Squarepants
Somebody Kill Me -- Adam Sandler
Paradise City -- Guns N' Roses
The Fresh Prince of Bel-Air -- DJ Jazzy Jeff & The Fresh Prince
Run Away - Radio Edit -- Sunstroke Project, Olia Tira
When We Didn't Get Along -- Danny Jacob
Down On Me -- Jeremih, 50 Cent
And She Was [E.T. Version] (45 Version) -- Talking Heads
Theme From Jeopardy! - Think Music -- TV Sounds Unlimited
Loser -- Beck
Choices (Yup) -- E-40
Turn Down For What - From "Alvin And The Chipmunks: The Road Chip" Soundtrack -- Alvin & The Chipmunks
Pokerap -- Pokémon
Spooky Scary Skeletons -- Spooky Scary Skeletons
Wanted Dead Or Alive -- Bon Jovi
Why You Always Lying? -- Nicholas Fraser
Hyrule Castle from "The Legend of Zelda: Breath Of The Wild" Video Game -- L'Orchestra Cinematique
Circle Of Life - From "The Lion King"/Soundtrack -- Carmen Twillie, Lebo M.
CoCo -- O.T. Genasis
Sweet Caroline - Single Version -- Neil Diamond
Sexy And I Know It -- LMFAO
New Bibi-Hendl (Extended Dance-Version) -- Takeo Ischi
My Little Pony Theme Song -- Twilight Sparkle, Apple Jack, Rainbow Dash, Pinkie Pie, Rarity, Fluttershy
Bitch -- Screamo
Welcome To Your Life -- Grouplove
Let's Take a Rocketship to Space -- Danny and the Jaytones
Every Sperm Is Sacred -- Monty Python
I Got You (I Feel Good) -- James Brown & The Famous Flames
Every Breath You Take - Remastered 2003 -- The Police
Dicks out for Harambe -- Rockie Gold
What Does The Fox Say -- I U 1 D C
Really Nice Day - Soundtrack -- Eric Idle, John Du Prez
Want You Gone -- Aperture Science Psychoacoustic Laboratories
Boogie Wonderland -- Earth, Wind & Fire, The Emotions
Ocean Man -- Ween
Friday -- Rebecca Black
April Showers -- PREPSZN Entertainment
Movie Star -- Bill Wurtz
If I Didn't Have You -- Billy Crystal, John Goodman
Soviet National Anthem (Hymne National De L'Urss) -- The Red Army Choir
Hurt -- Johnny Cash
Play My Music -- Jonas Brothers
Only Time -- Enya
Forever -- Drake, Kanye West, Lil Wayne, Eminem
Harder Better Faster Stronger -- Daft Punk
Roundabout - Remastered Version -- Yes
The Duck Song 3 -- Bryant Oden
Eat It -- "Weird Al" Yankovic
Otis McMusic -- Otis McDonald
Clint Eastwood -- Gorillaz
Livin' la Vida Loca -- Ricky Martin
Stronger -- Kanye West
1812 Overture -- Pyotr Ilyich Tchaikovsky, Royal Philharmonic Orchestra, Philip Ellis
Summer Of '69 -- Bryan Adams
Prologue -- John Williams
Dancing Queen -- ABBA
Rapper's Delight -- The Sugarhill Gang
Fox Baseball Theme Song -- All-Star Sports Machine
Gimme Three Steps -- Lynyrd Skynyrd
The Fox (What Does The Fox Say?) -- Ylvis
Wild Side -- Mötley Crüe
SpongeBob SquarePants Theme - Movie Version -- The Pirates
I'm Lindana and I Wanna Have Fun -- Lindana
(I Just) Died In Your Arms -- Cutting Crew
Through The Fire And Flames -- DragonForce
And She Was - 2005 Remastered Version -- Talking Heads
Crazy -- Gnarls Barkley
We No Speak Americano - Radio Edit -- Yolanda Be Cool, DCup
Here Comes The Sun - Remastered 2009 -- The Beatles
DONTTRUSTME -- 3OH!3
Stacy's Mom -- Bowling For Soup
SpongeBob SquarePants Theme -- Avril Lavigne
Y.M.C.A. -- Village People
Superstition -- Stevie Wonder
Forgot About Dre -- Dr. Dre, Eminem
Super Freak -- Rick James
Hex Girl -- Moon Sisters, The Nostalgia Girls
Rocket Man -- William Shatner, Steve Hillage
Convoy -- C.W. McCall
Sweatshirt -- Jacob Sartorius
Politics (feat. Foti) -- Josh A, Foti
Real American -- Rick Derringer
Too Many Rappers - featuring NAS -- Beastie Boys, Nas
The Duck Song -- Bryant Oden
Talk Dirty (feat. 2 Chainz) -- Jason Derulo, 2 Chainz
Get Lucky (feat. Pharrell Williams & Nile Rodgers) - Radio Edit -- Daft Punk, Pharrell Williams, Nile Rodgers
Points Of Authority / 99 Problems / One Step Closer -- JAY Z, Linkin Park
Fabulous -- Phineas, Bobby Fabulous
Super Mario Bros - Original -- Stryker Pose
Bed Intruder Song -- Antoine dodson & The Gregory Brothers, Antoine Dodson, The Gregory Brothers
Let's Get It Started - Spike Mix -- The Black Eyed Peas
Get Low -- Ying Yang Twins, Lil Jon & The East Side Boyz
KahootGm -- GraphicMuzik
Take Me Out -- Franz Ferdinand
Waving My Dick In The Wind -- Ween
Song 2 -- Blur
My Happy Ending -- Avril Lavigne
Come Sail Away -- Styx
Wake Me up Before You Go-Go -- Wham!
Gold Digger -- Kanye West, Jamie Foxx
No Rain -- Blind Melon
Ain't No Mountain High Enough -- Marvin Gaye, Tammi Terrell
Gillette -- 199X, Dr DisRespect
Blackout -- Breathe Carolina
Come Down -- Anderson .Paak
My Name Is -- Eminem
Sweet Victory -- David Glen Eisley, Bob Kulick
Far Away -- Tomppabeats
Back In Black -- AC/DC
Ebola (La La) -- Rucka Rucka Ali
S.O.S. -- Jonas Brothers
Phinedroids and Ferbots -- Phinedroids and Ferbots
Year 3000 -- Jonas Brothers
Low Rider -- War
Swimming Pools (Drank) - Extended Version -- Kendrick Lamar
Rape Me -- Nirvana
Never Gonna Give You Up -- Rick Astley
Rockaway Beach - Remastered Version -- Ramones
Look At Me! -- XXXTENTACION
My Tighty Whiteys -- Spongebob, Sandy, Mr. Krabs, Plankton & Patrick
Sweet Dreams (Are Made of This) - Remastered -- Eurythmics
Today is Gonna be a Great Day - Theme Song to Phineas and Ferb -- Bowling For Soup
Funky Town -- Lipps Inc.
Everybody (Backstreet's Back) - Radio Edit -- Backstreet Boys
I Want You Back -- The Jackson 5
The Batman Theme -- Danny Elfman
Heyyeyaaeyaaaeyaeyaa (Fabulous Secret Powers) -- SLACKCiRCUS
Don't Stop Believin' -- Journey
Footloose -- Kenny Loggins
Shia LaBeouf Live -- Rob Cantor
Smooth Criminal - 2012 Remaster -- Michael Jackson
Best I Ever Had -- Drake
Nippon Manjyuu -- LADYBABY
Smoke Weed Everyday (feat. Diezel) -- Trick Trick, Diezel
The Flaming Swastika -- Dario Russo
Ripped Pants -- Spongebob Squarepants
Fuck Tha Police -- N.W.A.
Mii Channel (Nintendo Wii) -- The OneUps
Tunak Tunak Tun -- Daler Mehndi
Asian Jake Paul -- iDubbbz, Boyinaband
Cara Mia Addio -- Aperture Science Psychoacoustic Laboratories
Wuthering Heights -- Kate Bush
Crazy Train - Remastered -- Ozzy Osbourne
Hey Jude - Remastered 2015 -- The Beatles
I'm On A Boat -- The Lonely Island, T-Pain
Let's Get It On -- Marvin Gaye
You've Got a Friend In Me - From "Toy Story" / Soundtrack -- Randy Newman
Deepthroat -- cupcakKe
????????? (???????????) - -- Yoko Takahashi
Immigrant Song -- Led Zeppelin
Fuck You -- CeeLo Green
It's Everyday Bro -- Jake Paul, Team 10
Straight Outta Compton - Extended Mix / Edit -- N.W.A.
Come A Little Bit Closer -- Jay & The Americans
Busted -- Candace, Vanessa
Kazoo Kid Trap - Original Mix -- Mike Diva
Badger Badger Badger -- Mr Weebl
Don't Stop Me Now - Remastered -- Queen
Finest Girl (Bin Laden Song) -- The Lonely Island
Africa -- Toto
Candyland -- Blood On The Dance Floor
Rock You Like a Hurricane -- Scorpions
Watch Me (Whip / Nae Nae) -- Silentó
Narwhals -- Mr Weebl
Move Bitch -- Disturbing Tha Peace, Ludacris, Mystikal, I-20
Milkshake - Radio Mix -- Kelis
Me and Julio Down by the Schoolyard -- Paul Simon
You Snuck Your Way Right Into My Heart -- Love Händel
Hungry Like The Wolf -- Duran Duran
Mine -- Bazzi
I'm Gonna Be (500 Miles) -- The Proclaimers
Stranger Things -- Kyle Dixon & Michael Stein
Green Trill Zone -- Sanic, Dr. Robotnek
Alphabet Shuffle -- Bill Wurtz
Boyz-N-The-Hood -- Eazy-E
The Final Countdown -- Europe
My Heart Will Go On - Dance Mix -- Leanora
What Is Love -- Haddaway
I Like Chinese -- Monty Python
Hooked on a Feeling -- Blue Swede, Björn Skifs
Mad World (Feat. Michael Andrews) -- Gary Jules, Michael Andrews
Welcome To The Jungle -- Guns N' Roses
Twitter Fingers -- at Wendys
Photograph -- Nickelback
PONPONPON -- Kyary Pamyu Pamyu
Ignition - Remix -- R. Kelly
The Simpsons Main Title Theme -- The Simpsons
Harlem Shake -- Baauer
Nickelodeon Girls -- Pink Guy
Fruit Salad -- The Wiggles
Holding It Down -- at Wendys
Little Brothers -- Stacy
The Real Slim Shady -- Eminem
All Star -- Smash Mouth
Oh Uganda, Land of Beauty (National Anthem of Uganda) -- Star Dreams Electric Studio Orchestra
Gang -- Max P, Danny Wolf
Duel Of The Fates -- London Voices, London Symphony Orchestra, John Williams, New London Children's Choir
We Are The Champions -- Queen
Piano Man -- Billy Joel
Bottoms Up - feat. Nicki Minaj -- Trey Songz
Billie Jean -- Michael Jackson
Baby Got Back -- Sir Mix-A-Lot
Walk This Way -- Aerosmith
Spiderman -- T.V Themes
The Devil Went Down to Georgia -- The Charlie Daniels Band
Stand By Me -- Ben E. King
Super Smash Bros Melee (Main Theme) -- 8-Bit Arcade
Galaxy Song -- Monty Python
Motherlover -- The Lonely Island, Justin Timberlake
The Best of Both Worlds - From "Hannah Montana"/Soundtrack Version -- Hannah Montana
Wii Turn Up (Wii Menu Remix) -- Murcy
In The Air Tonight -- Phil Collins
4 for 4$ -- at Wendys
Hungry Like The Wolf - 2009 Remastered Version -- Duran Duran
Winner Winner -- Hovey Benjamin
Believe -- Cher
Guren No Yumiya -- Linked Horizon
Good Riddance (Time of Your Life) -- Green Day
My Heart Will Go On - Love Theme from "Titanic" -- Céline Dion
It's Raining Men -- The Weather Girls
Vida - Spanglish Version -- Ricky Martin
The Joker -- Steve Miller Band
Law and Order: Theme From Law and Order -- TV Theme Song Library
Leave It All To Me (Theme from iCarly) -- Miranda Cosgrove, Drake Bell
Why Don't You Get A Job -- The Offspring
Buddy Holly -- Weezer
Penis Song (Not The Noel Coward Song) -- Monty Python
The Anthem -- Good Charlotte
The Time Is Now (John Cena) -- John Cena, Tha Trademarc, WWE
My Dick -- Mickey Avalon
Russian National Anthem -- The Red Army Choir
Gangnam Style (?????) -- PSY
U Can't Touch This -- MC Hammer
Sweet Child O' Mine -- Guns N' Roses
Opps (with Yugen Blakrok) -- Vince Staples, Yugen Blakrok
The Suite Life of Zack and Cody -- TV Tunesters
Ni**as In Paris -- JAY Z, Kanye West
I Like To Move It -- Crazy Frog
Dat Boi (O Shit Waddup!) -- Dj Cutman
Sleeping With the Television On -- Billy Joel
Let It Go - From "Frozen"/Soundtrack Version -- Idina Menzel
Babooshka -- Kate Bush
I Just Had Sex -- The Lonely Island, Akon
Mr. Blue Sky -- Electric Light Orchestra
Bye Bye Bye -- *NSYNC
Krusty Krab Spongebob Trap Remix Vine Theme -- William Jacobs
My Goody Two-Shoes Brother -- Dr. Doofenshmirtz
Cantina Band - From "Star Wars: A New Hope" -- London Voices, London Symphony Orchestra, John Williams, New London Children's Choir
Basic Thugonomics -- John Cena, WWE
Fireflies -- Owl City
Backyard Beach -- Ferb
Epic Sax Guy -- S. Stepanov
Dream On -- Aerosmith
Pumped Up Kicks -- Foster The People
We like to Party! (The Vengabus) -- Vengaboys
Earth, Wind, Fire & Air -- Moon Sisters, The Nostalgia Girls
April Showers -- Proleter
Pirates of the Caribbean (Main Theme) -- The Intermezzo Orchestra
Truck Drivin' Girl -- Danny Jacob
X Gon' Give It To Ya -- DMX
Casin -- glue70
Run Away With Me -- Carly Rae Jepsen
Crank That (Soulja Boy) -- Soulja Boy
Don't Speak -- No Doubt
You Give Love A Bad Name -- Bon Jovi
Ghostbusters -- Ray Parker, Jr.
The Office Theme -- Michael Scott Fan Club
Carolina In My Mind -- James Taylor
Phil Of The Future Theme -- The Hit Crew
Gary's Song -- Spongebob Squarepants
Bodies -- Drowning Pool
Love On Top -- Beyoncé
Do Nothing Day -- Candace, Jeremy
Seinfeld -- TV Themes
Remember The Name (feat. Styles Of Beyond) -- Fort Minor, Styles Of Beyond
Gitchee Gitchee Goo -- Phineas and the Ferbtones
Like An Enderman -- ThnxCya
Rest in Grease -- at Wendys
Deja Vu (Initial D) -- Tsuko G.
Party In The U.S.A. -- Miley Cyrus
Mind Heist -- Zack Hemsey
Dr. Feelgood -- Mötley Crüe
Big Enough -- Kirin J Callinan, Alex Cameron, Molly Lewis, Jimmy Barnes
I Am A Gummy Bear (English) -- Gummibär
Raiders March -- John Williams
Major Tom (Coming Home) -- William Shatner, Nick Valensi
Stayin' Alive - From "Saturday Night Fever" Soundtrack -- Bee Gees
We Built This City -- Starship
Walking On Sunshine -- Katrina & The Waves
We Are One (Ole Ola) [The Official 2014 FIFA World Cup Song] (Opening Ceremony Version) -- Pitbull, Jennifer Lopez, Claudia Leitte
U Guessed It -- OG Maco
Jessie's Girl -- Rick Springfield
Man's Not Hot -- Big Shaq
Cocaine (feat. Lil Dicky) -- Brain, Lil Dicky
A Horse with No Name -- America
A Thousand Miles -- Vanessa Carlton
Blue (Da Ba Dee) -- Kidz Bop Kids
Freaky Friday (feat. Chris Brown) -- Lil Dicky, Chris Brown
Come Out and Play -- The Offspring
Last Christmas -- Wham!
Rasputin -- Turisas
Cotton Eye Joe -- Rednex
E.V.I.L. B.O.Y.S. -- Candace
The Creativity Song -- Don't Hug Me I'm Scared
Axel F - Radio Mix -- Crazy Frog
Closing Time -- Semisonic
Hey Ya! - Radio Mix / Club Mix -- OutKast
?????? ??? ????? -- Poyushchie vmeste
Take On Me -- a-ha
Common People -- William Shatner
My Undead Mummy and Me -- Danny Jacob
My Neck, My Back (Lick It) - Street/Club Version -- Khia
Man's Not Hot - Christmas Edition -- Big Shaq
Boom -- P.O.D.
Hollywood Nights -- Bob Seger
That's So Raven (Theme Song) -- Raven-Symoné
American Pie -- Don McLean
Dragostea Din Tei - Original Italian Version -- O-Zone
God's Plan -- Drake
Happy Together -- The Turtles
The Avengers -- Alan Silvestri
The Jellyfish Song (Music Box Version) -- Kleonlumi
Chop Suey! -- System Of A Down
Small Dick -- Pink Guy
I Love You Mom -- Candace
Outside -- Bill Wurtz
We Are Number One - Instrumental Version -- 4Fate
Watch Me (Whip / Nae Nae) -- Kidz Bop Kids
Ok 2 B Gay -- Tomboy
La de Da de Da de Da de Day Oh -- Bill Wurtz
Chains on Me -- The Smile Away Reformatory Glee Club, Dan Povenmire
Let's Go (feat. Ne-Yo) -- Calvin Harris, Ne-Yo
Holiday Road - National Lampoon's Vacation -- Lindsey Buckingham
Trololo Song -- Mr. Trololo
Why Can't We Be Friends -- Smash Mouth
Livin' On A Prayer -- Bon Jovi
Brandy (You're a Fine Girl) -- Looking Glass
I Can't -- Gucci Mane
Thomas Theme -- Thomas & Friends
Krusty Krab Pizza Song (Spongebob Remix) -- William Jacobs
Lose Yourself - Soundtrack Version -- Eminem
Come And Get Your Love -- Redbone
And She Was -- Talking Heads
I'll Be There For You [Theme From FRIENDS] (45 version) -- The Rembrandts
FACK -- Eminem
'Till I Collapse -- Eminem, Nate Dogg
Bill Nye the Science Guy -- Mr Dooves
Everything Is AWESOME!!! -- Tegan and Sara, The Lonely Island
Working for the Weekend -- Loverboy
Misirlou - Single Version -- Dick Dale and his Del-Tones
Down Under -- Men At Work
Rêverie -- Claude Debussy, Alain Planes
Ncis Theme -- Numeriklab
Separate Ways (Worlds Apart) -- Journey
Ain't No Rest for the Wicked -- Cage The Elephant
Careless Whisper -- George Michael
Pump It -- The Black Eyed Peas
Johnny B. Goode -- Chuck Berry
Loop de Loop -- Ween
In The Name Of God (Deus Vult) -- Powerwolf
Santa Diss Track -- Logan Paul
Like A Boss -- The Lonely Island
Shake That -- Eminem, Nate Dogg
Pokemon Theme -- Pokémon
Big Time Rush -- Big Time Rush
Peanut Butter Jelly Time - Radio -- Chip-man & The Buckwheat Boyz
Magic -- Pilot
Friend Zone (feat. Gracie Haschak) -- MattyB, Gracie Haschak
Bad Reputation -- Avril Lavigne
White & Nerdy (Parody of "Ridin'" by Chamillionaire feat. Krayzie Bone) -- "Weird Al" Yankovic
The One and Only -- Chesney Hawkes
I Am A Man Of Constant Sorrow - From O Brother, Where Art Thou Soundtrack / Radio Station Version -- The Soggy Bottom Boys, Dan Tyminski
Roxanne -- The Police
Hej Monica -- Nic & The Family
Renegade -- Styx
The Duck Song 2 -- Bryant Oden
You Spin Me Round (Like a Record) -- Dead Or Alive
You Reposted in the Wrong Neighborhood I Glue70 Mashup -- Shokk
Hefner -- Tana Mongeau
Mr. Sandman - 1954 #1 Billboard chart hit -- The Chordettes
We're All In This Together -- High School Musical Cast
Goodies -- Ciara, Petey Pablo
Unchained Melody -- The Righteous Brothers
Air Horn -- Gabriel Mercado
Campfire Song Song -- Spongebob Squarepants
Hard Knock Life (Ghetto Anthem) -- The Academy Allstars
Clownin -- at Wendys
Please Stop Calling Me Gay -- Pink Guy
Get Ready For This -- Crazy Frog
My Nigga -- YG, Jeezy, Rich Homie Quan
Taylor, The Latte Boy -- Susan Egan
